111111
100101
101001
110001
100001
100001
111111