1111111
1001001
1010001
1111111