1111111
1000001
1000001
10P0001
1111111s