111111111111111
100000100001
100000100001
10P000100001
111111111111111