1111111
1001011
1010011
1100011
100P011
1000011
1111111