1111111
1111111
1100011
1100011
1100011
1100011
1100011
1100011
1111111
1111111