1111111
1000011
1001011
1001011
1011011
1000011
1111111