1111111
1000011
1000011
1000011
1000011
1000011
1111111