NO ./path_to_the_north_texture
WE ./path_to_the_west_texture
F 220,100,100
EA ./path_to_the_east_texture
C             220,30,115          
SO ./path_to_the_south_texture






   111111111111  
  1101100001
 1 1100000111
 1 100N001
 1 1111111111






