NO ./assets/back_wat.xpm
WE ./assets/skeleton.xpm
F 242,210,169
      EA ./assets/wat_3.xpm
C            15,94,156
SO ./assets/wat_2.xpm






1111111111111 11111
1100000000000100001
1100000000000000001111
1100000000000000011111
1100000000000000011111
1100000000000000111111
100000000000E0000000001
10000000000001000000001
1100000000000000011111
11000000000000000111
11000000000000000111
11000000000000000111
11000000000000000111
11000000000000000111
111111111111111111






