NO ./assets/back_wat.xpm
WE ./assets/skeleton.xpm
F 242,210,169
      EA ./assets/wat_3.xpm
C            15,94,156
SO ./assets/wat_2.xpm






1111111111111 11111
1100000000000100001
1100000000000000001111
1100000000000000011111
110001111111100000000011111
11001111111000000000111111
1000011111102000000000000011
10000111110000001000000001
110001111100200000001111111
11000000000000000111
11000E000003000000111
11000004000000000111
11000000000300000111
1100004000000000111
111111111111111111






