NO ./assets/wall_thingy.xpm
WE ./assets/SPACE.xpm
F 100,100,0
      EA ./assets/beach.xpm
C             65,53,35
SO ./assets/wall_2.xpm






1111111111111111111
1100000000000100001
1100000000000000011111
1100000000000000011111
1100000000000000011111
1100000000000000111111
1000000000000N000000001
1100000000000000011111
11000000000000000111
11000000000000000111
11000000000000000111
11000000000000000111
11000000000000000111
11111111111111111






