NO ./assets/back_wat.xpm
WE ./assets/skeleton.xpm
F 242,210,169
      EA ./assets/wat_3.xpm
C            15,94,156
SO ./assets/wat_2.xpm






1111111111111 11111
1100000000000100001
1100000000000000001111
1100000000000000011111
110002224500000000011111
1100022245000000000111111
100002224500000000000000011
10000222450000001000000001
110002224500000000001111111
11000000000000000111
11000E000000000000111
11000000000000000111
11000000000000000111
11000000000000000111
111111111111111111






