NO ./assets/back_wat.xpm
WE ./assets/skeleton.xpm
EA ./assets/wat_3.xpm
SO ./assets/wat_2.xpm

F 242,210,169
C 15,94,156

 111111111111111
10000000S0000001
1000000000000001

1000000000100001
 11111111111111