NO ./path_to_the_north_texture
SO ./path_to_the_south_texture
WE ./path_to_the_west_texture
F 220,100,0
C 225,30,115
EA ./path_to_the_east_texture

111111  
 1000S1  
  111
1


