NO ./path_to_the_north_texture
SO ./path_to_the_south_texture
WE ./path_to_the_west_texture
EA ./path_to_the_east_texture
F 220,100,0
C 225,30,0




11111111111111
1000001      1111       11        
100N001       11            11        
1000001  1   111   
11111111111111   




