NO ./path_to_the_north_texture
SO ./path_to_the_south_texture
WE ./path_to_the_west_texture
F 220,100,0
C 225,30,0
EA ./path_to_the_east_texture





11111111111111
 1      1000001              11111     
 1      100N001            110111    
 1      1000001            111111111   
1      111111111111111  




